Иванов	География
Смирнов	Геометрия
Кузнецов	Музыка (Пение)
Попов	Музыка (Пение)
Васильев	Литература
Петров	Физкультура
Соколов	Биология
Михайлов	Изобразительное искусство (Рисование)
Новиков	Иностранный язык
Федоров	Музыка (Пение)
Морозов	Литература
Волков	География
Алексеев	Русский язык
Лебедев	Биология
Семенов	Физика
Егоров	Геометрия
Павлов	Иностранный язык
Козлов	Труд
Степанов	География
Николаев	Русский язык
Орлов	Алгебра
Андреев	Изобразительное искусство (Рисование)
Макаров	Информатика
Никитин	Иностранный язык
Захаров	Русский язык
Зайцев	Информатика
Соловьев	Биология
Борисов	Информатика
Яковлев	Русский язык
Григорьев	Музыка (Пение)
Романов	Русский язык
Воробьев	История
Сергеев	Труд
Кузьмин	Математика
Фролов	География
Александров	Биология
Дмитриев	История
Королев	Труд
Гусев	Изобразительное искусство (Рисование)
Киселев	Русский язык
Ильин	Труд
Максимов	Русский язык
Поляков	Химия
Сорокин	Литература
Виноградов	Иностранный язык
Ковалев	Физика
Белов	Труд
Медведев	Геометрия
Антонов	Труд
Тарасов	Физика
Жуков	Биология
Баранов	География
Филиппов	Труд
Комаров	Труд
Давыдов	Физика
Беляев	История
Герасимов	Геометрия
Богданов	Биология
Осипов	Информатика
Сидоров	Биология
Матвеев	Химия
Титов	Алгебра
Марков	Иностранный язык
Миронов	Информатика
Крылов	Физкультура
Куликов	Музыка (Пение)
Карпов	Музыка (Пение)
Власов	География
Мельников	Геометрия
Денисов	Изобразительное искусство (Рисование)
Гаврилов	Химия
Тихонов	Геометрия
Казаков	Изобразительное искусство (Рисование)
Афанасьев	История
Данилов	География
Савельев	Литература
Тимофеев	Физика
Фомин	Изобразительное искусство (Рисование)
Чернов	Биология
Абрамов	Физика
Мартынов	Иностранный язык
Ефимов	Алгебра
Федотов	Геометрия
Щербаков	Химия
Назаров	Труд
Калинин	Иностранный язык
Исаев	Химия
Чернышев	География
Быков	Информатика
Маслов	Информатика
Родионов	Математика
Коновалов	Химия
Лазарев	Труд
Воронин	Труд
Климов	История
Филатов	Алгебра
Пономарев	История
Голубев	Геометрия
Кудрявцев	Русский язык
Прохоров	Химия
Наумов	История
Потапов	Химия
Журавлев	Биология
Овчинников	Литература
Трофимов	Математика
Леонов	Русский язык
Соболев	Биология
Ермаков	Литература
Колесников	Математика
Гончаров	Литература
Емельянов	Литература
Никифоров	Математика
Грачев	Музыка (Пение)
Котов	Физкультура
Гришин	Труд
Ефремов	Музыка (Пение)
Архипов	Изобразительное искусство (Рисование)
Громов	Геометрия
Кириллов	Информатика
Малышев	Математика
Панов	Геометрия
Моисеев	Изобразительное искусство (Рисование)
Румянцев	Иностранный язык
Акимов	Русский язык
Кондратьев	Алгебра
Бирюков	Информатика
Горбунов	Иностранный язык
Анисимов	Физика
Еремин	Труд
Тихомиров	Физкультура
Галкин	География
Лукьянов	Алгебра
Михеев	Алгебра
Скворцов	История
Юдин	Литература
Белоусов	Труд
Нестеров	Физика
Симонов	Геометрия
Прокофьев	Информатика
Харитонов	Биология
Князев	Физкультура
Цветков	Музыка (Пение)
Левин	Физика
Митрофанов	Физика
Воронов	Русский язык
Аксенов	Физика
Софронов	Информатика
Мальцев	Геометрия
Логинов	Физика
Горшков	География
Савин	Физкультура
Краснов	Труд
Майоров	Труд
Демидов	Химия
Елисеев	История
Рыбаков	Изобразительное искусство (Рисование)
Сафонов	Литература
Плотников	История
Демин	Изобразительное искусство (Рисование)
Хохлов	Биология
Фадеев	Литература
Молчанов	Изобразительное искусство (Рисование)
Игнатов	Химия
Литвинов	Алгебра
Ершов	Литература
Ушаков	Химия
Дементьев	Труд
Рябов	Информатика
Мухин	Изобразительное искусство (Рисование)
Калашников	Биология
Леонтьев	Биология
Лобанов	Физкультура
Кузин	Музыка (Пение)
Корнеев	Алгебра
Евдокимов	Биология
Бородин	Физкультура
Платонов	География
Некрасов	Химия
Балашов	Изобразительное искусство (Рисование)
Бобров	История
Жданов	Математика
Блинов	Литература
Игнатьев	Алгебра
Коротков	Физика
Муравьев	Химия
Крюков	Химия
Беляков	Химия
Богомолов	Иностранный язык
Дроздов	Биология
Лавров	Физкультура
Зуев	Физика
Петухов	Русский язык
Ларин	Информатика
Никулин	Труд
Серов	Математика
Терентьев	Музыка (Пение)
Зотов	Изобразительное искусство (Рисование)
Устинов	Физкультура
Фокин	Музыка (Пение)
Самойлов	Математика
Константинов	Изобразительное искусство (Рисование)
Сахаров	Труд
Шишкин	Информатика
Самсонов	География
Черкасов	Информатика
Чистяков	Биология
Носов	Музыка (Пение)
Спиридонов	Литература
Карасев	Иностранный язык
Авдеев	История
Воронцов	Алгебра
Зверев	Информатика
Владимиров	Физкультура
Селезнев	Музыка (Пение)
Нечаев	Литература
Кудряшов	Физика
Седов	Иностранный язык
Фирсов	Труд
Андрианов	Алгебра
Панин	Биология
Головин	География
Терехов	Информатика
Ульянов	Русский язык
Шестаков	Русский язык
Агеев	Физика
Никонов	Алгебра
Селиванов	Литература
Баженов	Химия
Гордеев	Русский язык
Кожевников	География
Пахомов	Геометрия
Зимин	Физика
Костин	Биология
Широков	Физкультура
Филимонов	История
Ларионов	Иностранный язык
Овсянников	Геометрия
Сазонов	Русский язык
Суворов	Труд
Нефедов	Литература
Корнилов	Русский язык
Любимов	Информатика
Львов	Биология
Горбачев	Труд
Копылов	Музыка (Пение)
Лукин	Изобразительное искусство (Рисование)
Токарев	Математика
Кулешов	Иностранный язык
Шилов	История
Большаков	Информатика
Панкратов	Физкультура
Родин	Русский язык
Шаповалов	Русский язык
Покровский	История
Бочаров	География
Никольский	Математика
Маркин	Иностранный язык
Горелов	Литература
Агафонов	Русский язык
Березин	Химия
Ермолаев	Химия
Зубков	Химия
Куприянов	Иностранный язык
Трифонов	Геометрия
Масленников	Русский язык
Круглов	Математика
Третьяков	Химия
Колосов	География
Рожков	Информатика
Артамонов	География
Шмелев	Литература
Лаптев	История
Лапшин	Биология
Федосеев	Физкультура
Зиновьев	История
Зорин	География
Уткин	Химия
Столяров	Химия
Зубов	Математика
Ткачев	Музыка (Пение)
Дорофеев	Биология
Антипов	Информатика
Завьялов	Физкультура
Свиридов	Труд
Золотарев	Изобразительное искусство (Рисование)
Кулаков	География
Мещеряков	Информатика
Макеев	Физика
Дьяконов	Труд
Гуляев	Геометрия
Петровский	Труд
Бондарев	Химия
Поздняков	Музыка (Пение)
Панфилов	Иностранный язык
Кочетков	Геометрия
Суханов	Музыка (Пение)
Рыжов	Химия
Старостин	Литература
Калмыков	Информатика
Колесов	Иностранный язык
Золотов	Музыка (Пение)
Кравцов	Труд
Субботин	Литература
Шубин	Химия
Щукин	Алгебра
Лосев	Биология
Винокуров	История
Лапин	Физкультура
Парфенов	Физика
Исаков	Иностранный язык
Голованов	География
Коровин	Биология
Розанов	Литература
Артемов	Труд
Козырев	Русский язык
Русаков	Изобразительное искусство (Рисование)
Алешин	Алгебра
Крючков	Русский язык
Булгаков	Биология
Кошелев	Физика
Сычев	Математика
Синицын	Алгебра
Черных	Информатика
Рогов	Музыка (Пение)
Кононов	Химия
Лаврентьев	Алгебра
Евсеев	Геометрия
Пименов	Литература
Пантелеев	Алгебра
Горячев	Физкультура
Аникин	Русский язык
Лопатин	Русский язык
Рудаков	Литература
Одинцов	История
Серебряков	Биология
Панков	Биология
Дегтярев	Литература
Орехов	Музыка (Пение)
Царев	Иностранный язык
Шувалов	Литература
Кондрашов	Труд
Горюнов	История
Дубровин	Геометрия
Голиков	Физкультура
Курочкин	Физкультура
Латышев	География
Севастьянов	Информатика
Вавилов	Физкультура
Ерофеев	Химия
Сальников	Математика
Клюев	Математика
Носков	Математика
Озеров	Изобразительное искусство (Рисование)
Кольцов	Литература
Комиссаров	Литература
Меркулов	Труд
Киреев	Информатика
Хомяков	Химия
Булатов	Музыка (Пение)
Ананьев	Труд
Буров	История
Шапошников	Математика
Дружинин	Литература
Островский	Изобразительное искусство (Рисование)
Шевелев	Математика
Долгов	География
Суслов	Русский язык
Шевцов	Математика
Пастухов	История
Рубцов	Иностранный язык
Бычков	Биология
Глебов	Физкультура
Ильинский	География
Успенский	География
Дьяков	Геометрия
Кочетов	Иностранный язык
Вишневский	Биология
Высоцкий	Биология
Глухов	Алгебра
Дубов	Иностранный язык
Бессонов	История
Ситников	Геометрия
Астафьев	Математика
Мешков	Геометрия
Шаров	Литература
Яшин	Физкультура
Козловский	Литература
Туманов	Информатика
Басов	Математика
Корчагин	География
Болдырев	Литература
Олейников	Изобразительное искусство (Рисование)
Чумаков	История
Фомичев	Труд
Губанов	Музыка (Пение)
Дубинин	Изобразительное искусство (Рисование)
Шульгин	Труд
Касаткин	Биология
Пирогов	География
Семин	Физика
Трошин	Иностранный язык
Горохов	Физкультура
Стариков	История
Щеглов	Алгебра
Фетисов	География
Колпаков	Геометрия
Чесноков	Математика
Зыков	Музыка (Пение)
Верещагин	История
Минаев	Труд
Руднев	География
Троицкий	Литература
Окулов	Химия
Ширяев	Изобразительное искусство (Рисование)
Малинин	Литература
Черепанов	История
Измайлов	Физкультура
Алехин	Русский язык
Зеленин	Биология
Касьянов	Математика
Пугачев	История
Павловский	Математика
Чижов	Геометрия
Кондратов	Иностранный язык
Воронков	Алгебра
Капустин	Алгебра
Сотников	Биология
Демьянов	Биология
Косарев	Литература
Беликов	Алгебра
Сухарев	Геометрия
Белкин	Математика
Беспалов	Алгебра
Кулагин	Иностранный язык
Савицкий	Физика
Жаров	Математика
Хромов	Изобразительное искусство (Рисование)
Еремеев	Русский язык
Карташов	Биология
Астахов	Литература
Русанов	Геометрия
Сухов	История
Вешняков	Музыка (Пение)
Волошин	Музыка (Пение)
Козин	Иностранный язык
Худяков	Физкультура
Жилин	Физика
Малахов	Геометрия
Сизов	Физкультура
Ежов	Биология
Толкачев	Иностранный язык
Анохин	Труд
Вдовин	Информатика
Бабушкин	Изобразительное искусство (Рисование)
Усов	Иностранный язык
Лыков	Музыка (Пение)
Горлов	Геометрия
Коршунов	Изобразительное искусство (Рисование)
Маркелов	Русский язык
Постников	Литература
Черный	Информатика
Дорохов	Химия
Свешников	Физика
Гущин	Химия
Калугин	Иностранный язык
Блохин	Биология
Сурков	Математика
Кочергин	Физкультура
Греков	Музыка (Пение)
Казанцев	Химия
Швецов	Литература
Ермилов	Физика
Парамонов	Иностранный язык
Агапов	История
Минин	Труд
Корнев	Изобразительное искусство (Рисование)
Черняев	Изобразительное искусство (Рисование)
Гуров	Информатика
Ермолов	Химия
Сомов	География
Добрынин	Алгебра
Барсуков	Физкультура
Глушков	Математика
Чеботарев	Химия
Москвин	Химия
Уваров	Музыка (Пение)
Безруков	Музыка (Пение)
Муратов	Математика
Раков	География
Снегирев	Физика
Гладков	Литература
Злобин	Биология
Моргунов	География
Поликарпов	Труд
Рябинин	Информатика
Судаков	Геометрия
Кукушкин	Информатика
Калачев	Алгебра
Грибов	Русский язык
Елизаров	Физика
Звягинцев	Биология
Корольков	Физкультура
Федосов	Изобразительное искусство (Рисование)
